#==============#
#              #
#  |           #
#              #
#      ==      #
#              #
#              #
#         =    #
#              #
#   ===        #
#              # 
#          |   #
#              #
#              #
#==============#