!****iiiii)***@
#             #
#  |          #
#             #
#      --     #
#             #
#             #
#         -   #
#             #
#   ---       #
#             # 
#          |  #
#             #
#             #
#             #
$====iiiii(===%