!****     )***@
#             #
#  |          #
#             #
#      --     #
#             #
#             #
#         -   #
#             #
#   ---       #
#             # 
#          |  #
#             #
#             #
#             #
$====     (===%